******      *******
**********   ******
**    * ** * ******
*****    ****    **
*******     *******
*********     *****
****    ***********
*****           ***
        *******0***
      *************
   ****************
